DFRobot_Gesture_Touch	KEYWORD2

setGestureInterval	KEYWORD2
setGestureDistance	KEYWORD2
setSleep	KEYWORD2
enableFunction	KEYWORD2
disableFunction	KEYWORD2
getAnEvent	KEYWORD2

DF_OK	LITERAL1
DF_ERR	LITERAL1

DFGT_FUN_RIGHT	LITERAL1
DFGT_FUN_LEFT	LITERAL1
DFGT_FUN_BACK	LITERAL1
DFGT_FUN_FORWARD	LITERAL1
DFGT_FUN_PULLUP	LITERAL1
DFGT_FUN_PULLDOWN	LITERAL1
DFGT_FUN_TOUCH1	LITERAL1
DFGT_FUN_TOUCH2	LITERAL1
DFGT_FUN_TOUCH3	LITERAL1
DFGT_FUN_TOUCH4	LITERAL1
DFGT_FUN_TOUCH5	LITERAL1

DFGT_EVT_RIGHT	LITERAL1
DFGT_EVT_LEFT	LITERAL1
DFGT_EVT_BACK	LITERAL1
DFGT_EVT_FORWARD	LITERAL1
DFGT_EVT_PULLUP	LITERAL1
DFGT_EVT_PULLDOWN	LITERAL1
DFGT_EVT_PULLREMOVE	LITERAL1
DFGT_EVT_TOUCH1	LITERAL1
DFGT_EVT_TOUCH2	LITERAL1
DFGT_EVT_TOUCH3	LITERAL1
DFGT_EVT_TOUCH4	LITERAL1
DFGT_EVT_TOUCH5	LITERAL1